.....................
.....................
..WWWWWW.V.V.WWWWWW..
.........V.V.........
..WWW.WWWV.VWWW.WWW..
..V.V...........V.V..
..WWW.WWWWWWWWW.WWW..
.....................
W.WWWWWWWW.WWWWWWWW.W
.....................
.WWWWWWWWW.WWWWWWWWW.
.........V.V.........
.WWWWWWW.....WWWWWWW.
.......V.....V.......
.....................
.V.V.....V.V.....V.V.
.V.VWWWWWV.VWWWWWV.V.
.....................