.............................................................
.....................WWW.....................................
.....................V.V.....................................
.....................V.V.....................................
..........WWW........V.V........WWW...............WWW........
..........V.V........V.V........V.V..........................
..........V.V........V.V........V.V..........................
..........V.V........V.V........V.V..........................
..........WWW........V.V........WWW..........................
.....................V.V.....................................
.....................V.V.....................................
.....................V.V.....V...............................
.....WWW.............V.V.....V.............WWW...............
.....V.V.............V.V.....V.............V.V...............
.....V.V.............V.V...................V.V...............
.....V.V.............V.V...................V.V...............
.....WWW.............V.V...................WWW...............
.....................V.V.....................................
.....................V.V.....................................
.....................V.V.....................................
..........WWW........V.V........WWW..........................
..........V.V........V.V........V.V..........................
..........V.V........V.V........V.V..................V.......
..........V.V........V.V........V.V..................V.......
..........WWW........V.V........WWW..................V.......
.....................V.V.....................................
.....................V.V.....................................
.....................WWW.....................................
.............................................................