....................
....WWW.......WW....
....................
..W.................
....W.W.W...........
....................
......WWW.....W.....
....W.......W....W..
..........W.........
....W.....W.....W...